1 13 31
###############################
# b **    1       * *  *   *  #
#*# # # # # # #*# # # # # # # #
# ** *2    **  *  *  **  **   #
# # # # #w# # # # # # # #*# # #
#* **           *  * *       *#
#2#x# # #*# # # # # # # # #*# #
#    *   *      * * p*     ** #
#*# # # # # # # # #*#1#*# # # #
#    *f  **      f*         * #
# # # # # # # # #w#*# # # # # #
#**     *     *   *          2#
###############################
