3 30 15
###############
# *** ****4* *#
#*#*# # #*# # #
#*3 * *  * ** #
# # #*#*# #*#*#
#*** ******  x#
#*#*#*#*# #2# #
#* ***  *  ** #
# # # # #*# #*#
#****** * ** *#
#*# #1#*#*#*#1#
#1** **   * **#
# #*# # # #*# #
#* ** *      *#
#*#*# # # #*# #
#* * f*  * ***#
#*# # #*#*#*# #
# *p** 3 ** * #
#*# #*#*#*#*#s#
#****  *  *  *#
#*# # #*# #*# #
#**   **   ** #
#b# #*#*# # # #
# ***s *   ** #
#*# # # #*#*#*#
#* 1*  * * * *#
#*#*#*#2#*#*#*#
#***   *******#
#f# # # #*# # #
###############
