1 20 20
####################
#* ** *  ** *** * *#
# #*# #*#*# # #*#*##
# ***** * *******  #
#*# #*#*# #*# #*#*##
#1  * ******  *** *#
# # # #*#*# #*#1#b##
#**x   *******    *#
# #*# # #*# #*# #*##
#  d **   1  **    #
# #*# # # # #*# # ##
#** * ***  **    2 #
# # #*# # #*#*#*#*##
#*f f*  2**** * ***#
#*#p#*# #*#*# #*# ##
#**b*    *  ** * * #
#*# #*# #d#*#*# #*##
#  **   *** g** ***#
#f# #*# # #*# #*#*##
####################