2 13 35
###################################
#***  * ** 3 * * *   **  **** b   #
#*# #*#*# # #*#*#*# #*#*# #*#*#*# #
#   * *  *** ****** ** *1  ** **p #
#*#*#*# #*#*# # # #*# # #*# #*#*#*#
#  ** **  ******  *  ** *x*3*  ***#
# #s# # # # #*#*#*# #*#*# # # #*# #
# ***** **  1   *** ** * ** * ****#
# # #*#*# #*# # #*#*#*# # # #1#*# #
#*   2 *  *****  **    * f *** *  #
#*# #*#*#*# #*#*# #1#*# #*# # # # #
#**** *  ** ******** 2    *** b***#
###################################
