2 13 15
###############
#*s*   p ww   #
#b#*#g#d# # # #
# gws*sd*b b f#
#b#s#b#d#d# #w#
#b w ff w p   #
# # #f#b# #*# #
# d* sbsg *   #
# # #b#*# #g#w#
#dfg*d  bs* * #
# # #s# #d#s#w#
#fbw   w * g* #
###############
